⬛⬜⬛⬛⬛⬛⬛⬛⬛⬛⬛⬛⬛⬛⬛⬛⬛⬛⬛⬛⬛⬛⬛⬛⬛⬛⬛⬛⬛⬛⬛⬛⬛⬛⬛⬛⬛⬛⬛⬛⬛⬛⬛⬛⬛⬛⬛⬛⬛⬛⬛⬛⬛⬛⬛⬛⬛⬛⬛⬛⬛⬛⬛⬛⬛⬛⬛⬛⬛⬛⬛⬛⬛⬛⬛⬛⬛
⬛⬜⬜⬜⬛⬜⬜⬜⬜⬜⬛⬜⬜⬜⬛⬜⬜⬜⬛⬜⬛⬜⬜⬜⬜⬜⬜⬜⬜⬜⬛⬜⬜⬜⬜⬜⬜⬜⬜⬜⬜⬜⬛⬜⬜⬜⬜⬜⬜⬜⬛⬜⬜⬜⬜⬜⬛⬜⬜⬜⬜⬜⬜⬜⬛⬜⬜⬜⬜⬜⬜⬜⬜⬜⬛⬜⬛
⬛⬛⬛⬜⬛⬛⬛⬜⬛⬜⬛⬜⬛⬜⬛⬜⬛⬜⬛⬜⬛⬜⬛⬛⬛⬜⬛⬛⬛⬜⬛⬛⬛⬛⬛⬜⬛⬛⬛⬛⬛⬜⬛⬛⬛⬜⬛⬛⬛⬜⬛⬜⬛⬛⬛⬜⬛⬛⬛⬛⬛⬜⬛⬜⬛⬜⬛⬜⬛⬛⬛⬛⬛⬜⬛⬜⬛
⬛⬜⬜⬜⬛⬜⬜⬜⬛⬜⬜⬜⬛⬜⬛⬜⬛⬜⬜⬜⬛⬜⬜⬜⬛⬜⬛⬜⬜⬜⬜⬜⬜⬜⬛⬜⬛⬜⬜⬜⬛⬜⬜⬜⬜⬜⬛⬜⬛⬜⬜⬜⬛⬜⬛⬜⬛⬜⬜⬜⬜⬜⬛⬜⬜⬜⬛⬜⬛⬜⬜⬜⬛⬜⬛⬜⬛
⬛⬜⬛⬛⬛⬜⬛⬛⬛⬛⬛⬛⬛⬜⬛⬜⬛⬛⬛⬜⬛⬛⬛⬜⬛⬜⬛⬛⬛⬛⬛⬛⬛⬜⬛⬜⬛⬜⬛⬜⬛⬛⬛⬛⬛⬛⬛⬜⬛⬛⬛⬛⬛⬜⬛⬜⬛⬜⬛⬜⬛⬛⬛⬛⬛⬛⬛⬜⬛⬜⬛⬜⬛⬜⬛⬜⬛
⬛⬜⬛⬜⬜⬜⬛⬜⬛⬜⬜⬜⬜⬜⬛⬜⬛⬜⬜⬜⬜⬜⬛⬜⬛⬜⬜⬜⬜⬜⬛⬜⬜⬜⬜⬜⬛⬜⬛⬜⬛⬜⬜⬜⬜⬜⬛⬜⬜⬜⬛⬜⬜⬜⬛⬜⬛⬜⬛⬜⬛⬜⬜⬜⬜⬜⬛⬜⬛⬜⬛⬜⬛⬜⬛⬜⬛
⬛⬜⬛⬜⬛⬛⬛⬜⬛⬜⬛⬛⬛⬛⬛⬜⬛⬜⬛⬛⬛⬛⬛⬜⬛⬛⬛⬛⬛⬜⬛⬛⬛⬛⬛⬛⬛⬜⬛⬜⬛⬜⬛⬜⬛⬛⬛⬜⬛⬜⬛⬜⬛⬜⬛⬜⬛⬜⬛⬛⬛⬜⬛⬛⬛⬜⬛⬛⬛⬜⬛⬜⬛⬜⬛⬜⬛
⬛⬜⬜⬜⬛⬜⬜⬜⬛⬜⬛⬜⬜⬜⬜⬜⬛⬜⬜⬜⬛⬜⬜⬜⬛⬜⬜⬜⬛⬜⬜⬜⬜⬜⬛⬜⬜⬜⬛⬜⬜⬜⬛⬜⬜⬜⬜⬜⬛⬜⬛⬜⬛⬜⬜⬜⬛⬜⬜⬜⬜⬜⬜⬜⬛⬜⬜⬜⬜⬜⬛⬜⬛⬜⬛⬜⬛
⬛⬛⬛⬛⬛⬜⬛⬜⬛⬜⬛⬜⬛⬛⬛⬛⬛⬛⬛⬛⬛⬜⬛⬛⬛⬜⬛⬛⬛⬛⬛⬛⬛⬜⬛⬜⬛⬛⬛⬛⬛⬛⬛⬛⬛⬛⬛⬜⬛⬜⬛⬜⬛⬛⬛⬛⬛⬛⬛⬜⬛⬛⬛⬛⬛⬛⬛⬛⬛⬜⬛⬜⬛⬜⬛⬜⬛
⬛⬜⬛⬜⬜⬜⬛⬜⬛⬜⬛⬜⬜⬜⬜⬜⬜⬜⬜⬜⬜⬜⬜⬜⬜⬜⬛⬜⬜⬜⬜⬜⬛⬜⬛⬜⬜⬜⬜⬜⬛⬜⬜⬜⬜⬜⬛⬜⬛⬜⬛⬜⬛⬜⬜⬜⬜⬜⬛⬜⬛⬜⬜⬜⬜⬜⬜⬜⬛⬜⬛⬜⬛⬜⬜⬜⬛
⬛⬜⬛⬜⬛⬛⬛⬜⬛⬜⬛⬜⬛⬛⬛⬛⬛⬛⬛⬛⬛⬛⬛⬛⬛⬛⬛⬜⬛⬛⬛⬜⬛⬜⬛⬛⬛⬜⬛⬛⬛⬜⬛⬛⬛⬜⬛⬛⬛⬜⬛⬜⬛⬜⬛⬛⬛⬜⬛⬜⬛⬜⬛⬛⬛⬛⬛⬜⬛⬜⬛⬜⬛⬛⬛⬜⬛
⬛⬜⬜⬜⬛⬜⬜⬜⬛⬜⬛⬜⬜⬜⬛⬜⬜⬜⬜⬜⬜⬜⬛⬜⬜⬜⬛⬜⬜⬜⬛⬜⬜⬜⬛⬜⬛⬜⬛⬜⬜⬜⬛⬜⬜⬜⬜⬜⬛⬜⬛⬜⬛⬜⬛⬜⬛⬜⬛⬜⬛⬜⬛⬜⬜⬜⬛⬜⬛⬜⬛⬜⬜⬜⬛⬜⬛
⬛⬜⬛⬛⬛⬜⬛⬜⬛⬜⬛⬛⬛⬛⬛⬜⬛⬛⬛⬛⬛⬜⬛⬜⬛⬜⬛⬛⬛⬜⬛⬛⬛⬛⬛⬜⬛⬜⬛⬜⬛⬛⬛⬛⬛⬛⬛⬜⬛⬜⬛⬜⬛⬜⬛⬜⬛⬜⬛⬜⬛⬜⬛⬜⬛⬛⬛⬜⬛⬜⬛⬛⬛⬜⬛⬜⬛
⬛⬜⬜⬜⬛⬜⬛⬜⬛⬜⬜⬜⬜⬜⬜⬜⬛⬜⬜⬜⬛⬜⬜⬜⬛⬜⬜⬜⬛⬜⬛⬜⬛⬜⬜⬜⬜⬜⬛⬜⬛⬜⬜⬜⬛⬜⬜⬜⬛⬜⬛⬜⬜⬜⬛⬜⬜⬜⬛⬜⬛⬜⬛⬜⬜⬜⬜⬜⬛⬜⬛⬜⬛⬜⬛⬜⬛
⬛⬛⬛⬜⬛⬜⬛⬛⬛⬛⬛⬛⬛⬛⬛⬛⬛⬜⬛⬜⬛⬛⬛⬛⬛⬛⬛⬜⬛⬜⬛⬜⬛⬜⬛⬛⬛⬛⬛⬜⬛⬜⬛⬜⬛⬜⬛⬛⬛⬜⬛⬛⬛⬛⬛⬜⬛⬛⬛⬛⬛⬜⬛⬛⬛⬜⬛⬛⬛⬜⬛⬜⬛⬜⬛⬛⬛
⬛⬜⬜⬜⬛⬜⬜⬜⬜⬜⬜⬜⬜⬜⬜⬜⬜⬜⬛⬜⬛⬜⬜⬜⬜⬜⬛⬜⬜⬜⬛⬜⬜⬜⬜⬜⬜⬜⬛⬜⬜⬜⬛⬜⬛⬜⬛⬜⬜⬜⬛⬜⬜⬜⬛⬜⬜⬜⬜⬜⬛⬜⬜⬜⬛⬜⬛⬜⬛⬜⬛⬜⬛⬜⬜⬜⬛
⬛⬜⬛⬛⬛⬛⬛⬛⬛⬛⬛⬛⬛⬛⬛⬜⬛⬜⬛⬜⬛⬜⬛⬛⬛⬜⬛⬛⬛⬛⬛⬛⬛⬛⬛⬛⬛⬛⬛⬛⬛⬜⬛⬜⬛⬜⬛⬛⬛⬜⬛⬜⬛⬜⬛⬛⬛⬛⬛⬜⬛⬛⬛⬜⬛⬜⬛⬜⬛⬜⬛⬜⬛⬛⬛⬜⬛
⬛⬜⬜⬜⬜⬜⬛⬜⬜⬜⬜⬜⬜⬜⬛⬜⬛⬜⬛⬜⬛⬜⬛⬜⬛⬜⬜⬜⬜⬜⬜⬜⬜⬜⬜⬜⬛⬜⬜⬜⬛⬜⬛⬜⬛⬜⬜⬜⬛⬜⬜⬜⬛⬜⬜⬜⬜⬜⬛⬜⬜⬜⬜⬜⬛⬜⬛⬜⬛⬜⬛⬜⬜⬜⬛⬜⬛
⬛⬜⬛⬛⬛⬛⬛⬜⬛⬛⬛⬛⬛⬜⬛⬛⬛⬜⬛⬜⬛⬜⬛⬜⬛⬛⬛⬛⬛⬜⬛⬛⬛⬛⬛⬜⬛⬜⬛⬜⬛⬜⬛⬜⬛⬛⬛⬜⬛⬛⬛⬜⬛⬛⬛⬜⬛⬛⬛⬛⬛⬛⬛⬛⬛⬜⬛⬜⬛⬜⬛⬛⬛⬜⬛⬜⬛
⬛⬜⬛⬜⬜⬜⬜⬜⬛⬜⬜⬜⬜⬜⬛⬜⬜⬜⬛⬜⬛⬜⬜⬜⬛⬜⬜⬜⬜⬜⬛⬜⬜⬜⬜⬜⬛⬜⬛⬜⬛⬜⬛⬜⬜⬜⬛⬜⬜⬜⬛⬜⬛⬜⬛⬜⬜⬜⬜⬜⬜⬜⬜⬜⬛⬜⬛⬜⬜⬜⬜⬜⬜⬜⬛⬜⬛
⬛⬜⬛⬜⬛⬛⬛⬛⬛⬛⬛⬛⬛⬜⬛⬜⬛⬛⬛⬛⬛⬜⬛⬛⬛⬜⬛⬛⬛⬛⬛⬜⬛⬛⬛⬛⬛⬜⬛⬜⬛⬛⬛⬛⬛⬜⬛⬛⬛⬜⬛⬜⬛⬜⬛⬛⬛⬛⬛⬜⬛⬛⬛⬜⬛⬜⬛⬛⬛⬛⬛⬛⬛⬛⬛⬜⬛
⬛⬜⬛⬜⬜⬜⬜⬜⬜⬜⬜⬜⬛⬜⬛⬜⬜⬜⬜⬜⬜⬜⬛⬜⬜⬜⬛⬜⬜⬜⬛⬜⬜⬜⬜⬜⬛⬜⬛⬜⬜⬜⬛⬜⬜⬜⬛⬜⬛⬜⬛⬜⬜⬜⬜⬜⬜⬜⬛⬜⬜⬜⬛⬜⬛⬜⬜⬜⬜⬜⬜⬜⬜⬜⬜⬜⬛
⬛⬜⬛⬛⬛⬛⬛⬛⬛⬜⬛⬜⬛⬜⬛⬛⬛⬛⬛⬛⬛⬛⬛⬜⬛⬛⬛⬜⬛⬛⬛⬛⬛⬛⬛⬜⬛⬜⬛⬛⬛⬜⬛⬜⬛⬛⬛⬜⬛⬜⬛⬛⬛⬛⬛⬛⬛⬜⬛⬛⬛⬜⬛⬛⬛⬛⬛⬛⬛⬛⬛⬛⬛⬛⬛⬜⬛
⬛⬜⬛⬜⬜⬜⬜⬜⬛⬜⬛⬜⬛⬜⬜⬜⬜⬜⬜⬜⬜⬜⬛⬜⬛⬜⬜⬜⬜⬜⬜⬜⬜⬜⬛⬜⬛⬜⬜⬜⬛⬜⬜⬜⬛⬜⬜⬜⬛⬜⬜⬜⬜⬜⬜⬜⬛⬜⬛⬜⬜⬜⬛⬜⬜⬜⬜⬜⬜⬜⬜⬜⬜⬜⬛⬜⬛
⬛⬛⬛⬜⬛⬛⬛⬜⬛⬛⬛⬜⬛⬛⬛⬛⬛⬛⬛⬛⬛⬜⬛⬜⬛⬜⬛⬛⬛⬜⬛⬛⬛⬜⬛⬜⬛⬜⬛⬜⬛⬛⬛⬛⬛⬜⬛⬜⬛⬛⬛⬛⬛⬛⬛⬜⬛⬜⬛⬜⬛⬛⬛⬜⬛⬛⬛⬛⬛⬜⬛⬛⬛⬜⬛⬜⬛
⬛⬜⬜⬜⬛⬜⬜⬜⬜⬜⬛⬜⬛⬜⬜⬜⬜⬜⬛⬜⬜⬜⬛⬜⬛⬜⬛⬜⬛⬜⬜⬜⬛⬜⬛⬜⬛⬜⬛⬜⬜⬜⬜⬜⬛⬜⬛⬜⬛⬜⬜⬜⬜⬜⬜⬜⬛⬜⬛⬜⬜⬜⬜⬜⬛⬜⬜⬜⬜⬜⬛⬜⬜⬜⬛⬜⬛
⬛⬜⬛⬛⬛⬛⬛⬛⬛⬜⬛⬜⬛⬛⬛⬜⬛⬜⬛⬜⬛⬛⬛⬜⬛⬜⬛⬜⬛⬛⬛⬜⬛⬛⬛⬜⬛⬛⬛⬛⬛⬛⬛⬜⬛⬜⬛⬜⬛⬜⬛⬛⬛⬛⬛⬛⬛⬛⬛⬛⬛⬛⬛⬛⬛⬜⬛⬛⬛⬛⬛⬜⬛⬛⬛⬜⬛
⬛⬜⬜⬜⬜⬜⬛⬜⬜⬜⬛⬜⬛⬜⬜⬜⬛⬜⬛⬜⬜⬜⬜⬜⬛⬜⬛⬜⬜⬜⬛⬜⬜⬜⬜⬜⬛⬜⬜⬜⬜⬜⬛⬜⬛⬜⬛⬜⬜⬜⬛⬜⬜⬜⬜⬜⬜⬜⬜⬜⬜⬜⬜⬜⬜⬜⬛⬜⬜⬜⬜⬜⬜⬜⬛⬜⬛
⬛⬛⬛⬛⬛⬜⬛⬜⬛⬛⬛⬜⬛⬜⬛⬛⬛⬛⬛⬛⬛⬛⬛⬛⬛⬜⬛⬛⬛⬜⬛⬛⬛⬛⬛⬛⬛⬜⬛⬛⬛⬜⬛⬜⬛⬜⬛⬛⬛⬛⬛⬛⬛⬜⬛⬛⬛⬛⬛⬛⬛⬛⬛⬛⬛⬛⬛⬛⬛⬛⬛⬜⬛⬛⬛⬜⬛
⬛⬜⬜⬜⬜⬜⬛⬜⬜⬜⬜⬜⬛⬜⬜⬜⬜⬜⬜⬜⬛⬜⬜⬜⬛⬜⬜⬜⬜⬜⬜⬜⬜⬜⬜⬜⬛⬜⬛⬜⬛⬜⬜⬜⬛⬜⬜⬜⬜⬜⬜⬜⬛⬜⬛⬜⬜⬜⬛⬜⬜⬜⬛⬜⬜⬜⬜⬜⬜⬜⬛⬜⬛⬜⬜⬜⬛
⬛⬜⬛⬛⬛⬛⬛⬛⬛⬛⬛⬛⬛⬜⬛⬛⬛⬜⬛⬜⬛⬛⬛⬜⬛⬛⬛⬛⬛⬛⬛⬛⬛⬛⬛⬜⬛⬜⬛⬜⬛⬜⬛⬛⬛⬛⬛⬛⬛⬛⬛⬜⬛⬜⬛⬜⬛⬜⬛⬜⬛⬜⬛⬜⬛⬛⬛⬛⬛⬜⬛⬜⬛⬜⬛⬛⬛
⬛⬜⬜⬜⬛⬜⬜⬜⬛⬜⬜⬜⬛⬜⬜⬜⬛⬜⬛⬜⬜⬜⬜⬜⬛⬜⬜⬜⬜⬜⬜⬜⬜⬜⬛⬜⬜⬜⬛⬜⬛⬜⬛⬜⬜⬜⬜⬜⬛⬜⬛⬜⬛⬜⬜⬜⬛⬜⬜⬜⬛⬜⬛⬜⬜⬜⬜⬜⬛⬜⬛⬜⬛⬜⬜⬜⬛
⬛⬜⬛⬜⬛⬜⬛⬜⬛⬛⬛⬜⬛⬜⬛⬛⬛⬜⬛⬛⬛⬛⬛⬜⬛⬜⬛⬜⬛⬛⬛⬛⬛⬜⬛⬛⬛⬛⬛⬜⬛⬜⬛⬜⬛⬛⬛⬜⬛⬜⬛⬜⬛⬛⬛⬜⬛⬛⬛⬛⬛⬜⬛⬛⬛⬛⬛⬜⬛⬜⬛⬛⬛⬛⬛⬜⬛
⬛⬜⬛⬜⬜⬜⬛⬜⬛⬜⬜⬜⬛⬜⬛⬜⬜⬜⬛⬜⬜⬜⬜⬜⬛⬜⬛⬜⬛⬜⬜⬜⬛⬜⬛⬜⬜⬜⬛⬜⬜⬜⬛⬜⬛⬜⬜⬜⬛⬜⬜⬜⬜⬜⬛⬜⬛⬜⬜⬜⬜⬜⬛⬜⬜⬜⬛⬜⬛⬜⬜⬜⬜⬜⬛⬜⬛
⬛⬜⬛⬛⬛⬛⬛⬜⬛⬜⬛⬛⬛⬜⬛⬜⬛⬜⬛⬛⬛⬛⬛⬛⬛⬜⬛⬜⬛⬛⬛⬜⬛⬜⬛⬜⬛⬜⬛⬜⬛⬛⬛⬜⬛⬜⬛⬛⬛⬛⬛⬛⬛⬜⬛⬛⬛⬜⬛⬜⬛⬛⬛⬜⬛⬜⬛⬜⬛⬛⬛⬛⬛⬜⬛⬜⬛
⬛⬜⬛⬜⬜⬜⬛⬜⬛⬜⬜⬜⬜⬜⬛⬜⬛⬜⬛⬜⬜⬜⬜⬜⬜⬜⬛⬜⬜⬜⬛⬜⬜⬜⬛⬜⬛⬜⬜⬜⬛⬜⬜⬜⬛⬜⬜⬜⬛⬜⬜⬜⬛⬜⬜⬜⬜⬜⬛⬜⬛⬜⬜⬜⬛⬜⬜⬜⬜⬜⬛⬜⬜⬜⬛⬜⬛
⬛⬜⬛⬜⬛⬜⬛⬜⬛⬜⬛⬛⬛⬛⬛⬜⬛⬛⬛⬜⬛⬛⬛⬛⬛⬛⬛⬛⬛⬜⬛⬛⬛⬛⬛⬜⬛⬛⬛⬛⬛⬜⬛⬛⬛⬛⬛⬜⬛⬜⬛⬜⬛⬛⬛⬛⬛⬛⬛⬜⬛⬜⬛⬛⬛⬛⬛⬛⬛⬛⬛⬜⬛⬜⬛⬜⬛
⬛⬜⬛⬜⬛⬜⬜⬜⬛⬜⬛⬜⬜⬜⬛⬜⬜⬜⬜⬜⬜⬜⬛⬜⬜⬜⬛⬜⬜⬜⬛⬜⬜⬜⬜⬜⬜⬜⬛⬜⬜⬜⬛⬜⬜⬜⬛⬜⬛⬜⬛⬜⬛⬜⬜⬜⬛⬜⬜⬜⬛⬜⬜⬜⬜⬜⬜⬜⬛⬜⬜⬜⬛⬜⬛⬜⬛
⬛⬜⬛⬜⬛⬛⬛⬛⬛⬜⬛⬛⬛⬜⬛⬛⬛⬛⬛⬛⬛⬜⬛⬜⬛⬜⬛⬜⬛⬛⬛⬜⬛⬛⬛⬛⬛⬛⬛⬜⬛⬛⬛⬜⬛⬜⬛⬜⬛⬜⬛⬜⬛⬜⬛⬜⬛⬛⬛⬛⬛⬛⬛⬜⬛⬛⬛⬛⬛⬜⬛⬛⬛⬜⬛⬜⬛
⬛⬜⬛⬜⬛⬜⬜⬜⬜⬜⬜⬜⬜⬜⬛⬜⬜⬜⬜⬜⬛⬜⬛⬜⬛⬜⬛⬜⬜⬜⬜⬜⬛⬜⬛⬜⬜⬜⬜⬜⬛⬜⬜⬜⬛⬜⬛⬜⬜⬜⬛⬜⬜⬜⬛⬜⬛⬜⬜⬜⬜⬜⬜⬜⬛⬜⬜⬜⬜⬜⬛⬜⬜⬜⬛⬜⬛
⬛⬜⬛⬜⬛⬜⬛⬛⬛⬛⬛⬛⬛⬜⬛⬜⬛⬛⬛⬜⬛⬛⬛⬜⬛⬜⬛⬛⬛⬜⬛⬛⬛⬜⬛⬜⬛⬛⬛⬛⬛⬜⬛⬛⬛⬜⬛⬛⬛⬛⬛⬛⬛⬛⬛⬜⬛⬜⬛⬛⬛⬛⬛⬛⬛⬜⬛⬛⬛⬛⬛⬜⬛⬛⬛⬜⬛
⬛⬜⬛⬜⬛⬜⬛⬜⬜⬜⬜⬜⬛⬜⬛⬜⬛⬜⬜⬜⬛⬜⬜⬜⬛⬜⬜⬜⬛⬜⬛⬜⬜⬜⬛⬜⬛⬜⬜⬜⬜⬜⬛⬜⬜⬜⬛⬜⬜⬜⬛⬜⬜⬜⬛⬜⬜⬜⬜⬜⬛⬜⬜⬜⬛⬜⬜⬜⬛⬜⬜⬜⬛⬜⬛⬜⬛
⬛⬜⬛⬜⬛⬛⬛⬜⬛⬛⬛⬜⬛⬛⬛⬜⬛⬜⬛⬛⬛⬜⬛⬛⬛⬛⬛⬜⬛⬜⬛⬛⬛⬜⬛⬜⬛⬛⬛⬛⬛⬜⬛⬜⬛⬛⬛⬜⬛⬜⬛⬛⬛⬜⬛⬛⬛⬛⬛⬛⬛⬜⬛⬜⬛⬛⬛⬜⬛⬛⬛⬜⬛⬜⬛⬜⬛
⬛⬜⬛⬜⬛⬜⬜⬜⬛⬜⬛⬜⬜⬜⬛⬜⬛⬜⬜⬜⬜⬜⬛⬜⬜⬜⬛⬜⬛⬜⬛⬜⬜⬜⬛⬜⬜⬜⬜⬜⬜⬜⬛⬜⬜⬜⬜⬜⬛⬜⬜⬜⬜⬜⬛⬜⬜⬜⬛⬜⬜⬜⬛⬜⬜⬜⬛⬜⬜⬜⬛⬜⬜⬜⬛⬜⬛
⬛⬜⬛⬜⬛⬜⬛⬛⬛⬜⬛⬛⬛⬜⬛⬜⬛⬛⬛⬛⬛⬛⬛⬛⬛⬜⬛⬜⬛⬜⬛⬜⬛⬜⬛⬛⬛⬛⬛⬛⬛⬛⬛⬛⬛⬛⬛⬛⬛⬛⬛⬛⬛⬜⬛⬛⬛⬜⬛⬜⬛⬛⬛⬛⬛⬜⬛⬛⬛⬜⬛⬜⬛⬛⬛⬜⬛
⬛⬜⬛⬜⬛⬜⬛⬜⬜⬜⬜⬜⬛⬜⬜⬜⬛⬜⬜⬜⬜⬜⬜⬜⬛⬜⬛⬜⬛⬜⬜⬜⬛⬜⬛⬜⬜⬜⬜⬜⬛⬜⬜⬜⬜⬜⬜⬜⬛⬜⬜⬜⬛⬜⬛⬜⬜⬜⬛⬜⬜⬜⬛⬜⬜⬜⬜⬜⬜⬜⬛⬜⬛⬜⬜⬜⬛
⬛⬜⬛⬜⬛⬜⬛⬛⬛⬛⬛⬜⬛⬛⬛⬛⬛⬜⬛⬛⬛⬛⬛⬜⬛⬜⬛⬜⬛⬛⬛⬛⬛⬜⬛⬜⬛⬛⬛⬜⬛⬜⬛⬛⬛⬜⬛⬜⬛⬜⬛⬜⬛⬜⬛⬜⬛⬜⬛⬛⬛⬜⬛⬜⬛⬛⬛⬛⬛⬛⬛⬛⬛⬜⬛⬛⬛
⬛⬜⬛⬜⬛⬜⬜⬜⬜⬜⬜⬜⬛⬜⬜⬜⬜⬜⬛⬜⬜⬜⬛⬜⬛⬜⬛⬜⬜⬜⬜⬜⬛⬜⬛⬜⬛⬜⬛⬜⬜⬜⬛⬜⬛⬜⬛⬜⬛⬜⬛⬜⬜⬜⬛⬜⬛⬜⬜⬜⬛⬜⬛⬜⬜⬜⬛⬜⬜⬜⬜⬜⬛⬜⬛⬜⬛
⬛⬛⬛⬜⬛⬛⬛⬛⬛⬛⬛⬜⬛⬜⬛⬛⬛⬛⬛⬛⬛⬜⬛⬜⬛⬜⬛⬛⬛⬛⬛⬜⬛⬛⬛⬜⬛⬜⬛⬛⬛⬛⬛⬜⬛⬜⬛⬛⬛⬜⬛⬛⬛⬛⬛⬜⬛⬛⬛⬛⬛⬜⬛⬛⬛⬛⬛⬜⬛⬛⬛⬜⬛⬜⬛⬜⬛
⬛⬜⬜⬜⬛⬜⬜⬜⬛⬜⬜⬜⬛⬜⬛⬜⬜⬜⬜⬜⬛⬜⬜⬜⬜⬜⬜⬜⬛⬜⬛⬜⬜⬜⬛⬜⬜⬜⬛⬜⬜⬜⬜⬜⬛⬜⬛⬜⬜⬜⬛⬜⬜⬜⬜⬜⬛⬜⬜⬜⬜⬜⬛⬜⬜⬜⬛⬜⬛⬜⬛⬜⬜⬜⬛⬜⬛
⬛⬜⬛⬜⬛⬜⬛⬜⬛⬜⬛⬛⬛⬜⬛⬜⬛⬛⬛⬜⬛⬛⬛⬛⬛⬛⬛⬜⬛⬜⬛⬛⬛⬜⬛⬛⬛⬜⬛⬜⬛⬛⬛⬜⬛⬜⬛⬜⬛⬛⬛⬛⬛⬜⬛⬜⬛⬜⬛⬛⬛⬛⬛⬜⬛⬜⬛⬜⬛⬜⬛⬛⬛⬛⬛⬜⬛
⬛⬜⬛⬜⬛⬜⬛⬜⬛⬜⬛⬜⬜⬜⬜⬜⬜⬜⬛⬜⬛⬜⬜⬜⬜⬜⬛⬜⬛⬜⬜⬜⬛⬜⬜⬜⬛⬜⬛⬜⬜⬜⬛⬜⬛⬜⬛⬜⬜⬜⬜⬜⬜⬜⬛⬜⬛⬜⬜⬜⬛⬜⬜⬜⬛⬜⬛⬜⬜⬜⬛⬜⬜⬜⬜⬜⬛
⬛⬜⬛⬛⬛⬜⬛⬜⬛⬜⬛⬜⬛⬛⬛⬛⬛⬛⬛⬜⬛⬜⬛⬛⬛⬜⬛⬜⬛⬜⬛⬜⬛⬜⬛⬜⬛⬜⬛⬛⬛⬛⬛⬜⬛⬜⬛⬛⬛⬛⬛⬛⬛⬛⬛⬜⬛⬛⬛⬜⬛⬜⬛⬛⬛⬜⬛⬛⬛⬜⬛⬜⬛⬛⬛⬛⬛
⬛⬜⬜⬜⬛⬜⬛⬜⬜⬜⬛⬜⬜⬜⬜⬜⬛⬜⬜⬜⬛⬜⬛⬜⬜⬜⬛⬜⬜⬜⬛⬜⬛⬜⬛⬜⬛⬜⬜⬜⬜⬜⬜⬜⬛⬜⬜⬜⬜⬜⬜⬜⬜⬜⬛⬜⬛⬜⬛⬜⬜⬜⬛⬜⬜⬜⬛⬜⬛⬜⬛⬜⬛⬜⬜⬜⬛
⬛⬛⬛⬜⬛⬜⬛⬛⬛⬛⬛⬜⬛⬛⬛⬛⬛⬜⬛⬛⬛⬜⬛⬜⬛⬛⬛⬛⬛⬛⬛⬛⬛⬜⬛⬜⬛⬛⬛⬛⬛⬛⬛⬜⬛⬛⬛⬜⬛⬛⬛⬜⬛⬛⬛⬜⬛⬜⬛⬛⬛⬛⬛⬜⬛⬜⬛⬜⬛⬜⬛⬜⬛⬜⬛⬜⬛
⬛⬜⬜⬜⬛⬜⬛⬜⬜⬜⬜⬜⬛⬜⬜⬜⬛⬜⬜⬜⬛⬜⬛⬜⬜⬜⬜⬜⬜⬜⬛⬜⬜⬜⬛⬜⬛⬜⬜⬜⬜⬜⬛⬜⬛⬜⬜⬜⬛⬜⬜⬜⬛⬜⬜⬜⬛⬜⬜⬜⬜⬜⬛⬜⬛⬜⬜⬜⬛⬜⬛⬜⬜⬜⬛⬜⬛
⬛⬜⬛⬜⬛⬜⬛⬜⬛⬛⬛⬛⬛⬜⬛⬜⬛⬜⬛⬜⬛⬜⬛⬛⬛⬛⬛⬛⬛⬜⬛⬜⬛⬛⬛⬜⬛⬜⬛⬜⬛⬛⬛⬜⬛⬜⬛⬛⬛⬛⬛⬛⬛⬜⬛⬛⬛⬜⬛⬛⬛⬜⬛⬜⬛⬛⬛⬛⬛⬜⬛⬛⬛⬛⬛⬜⬛
⬛⬜⬛⬜⬛⬜⬛⬜⬜⬜⬜⬜⬛⬜⬛⬜⬛⬜⬛⬜⬛⬜⬜⬜⬛⬜⬜⬜⬛⬜⬛⬜⬜⬜⬛⬜⬛⬜⬛⬜⬛⬜⬜⬜⬛⬜⬜⬜⬛⬜⬜⬜⬛⬜⬛⬜⬜⬜⬛⬜⬜⬜⬛⬜⬜⬜⬜⬜⬜⬜⬛⬜⬜⬜⬜⬜⬛
⬛⬜⬛⬛⬛⬜⬛⬛⬛⬛⬛⬜⬛⬜⬛⬜⬛⬛⬛⬜⬛⬛⬛⬜⬛⬜⬛⬜⬛⬜⬛⬛⬛⬜⬛⬛⬛⬜⬛⬜⬛⬜⬛⬛⬛⬛⬛⬜⬛⬜⬛⬜⬛⬜⬛⬜⬛⬛⬛⬛⬛⬜⬛⬛⬛⬛⬛⬛⬛⬛⬛⬜⬛⬛⬛⬜⬛
⬛⬜⬜⬜⬛⬜⬜⬜⬛⬜⬜⬜⬛⬜⬛⬜⬜⬜⬜⬜⬜⬜⬛⬜⬜⬜⬛⬜⬛⬜⬜⬜⬜⬜⬛⬜⬜⬜⬛⬜⬛⬜⬛⬜⬜⬜⬛⬜⬜⬜⬛⬜⬛⬜⬛⬜⬜⬜⬜⬜⬛⬜⬜⬜⬜⬜⬛⬜⬜⬜⬜⬜⬛⬜⬛⬜⬛
⬛⬜⬛⬜⬛⬛⬛⬜⬛⬛⬛⬛⬛⬜⬛⬛⬛⬛⬛⬛⬛⬛⬛⬜⬛⬛⬛⬜⬛⬛⬛⬛⬛⬛⬛⬜⬛⬛⬛⬜⬛⬜⬛⬛⬛⬜⬛⬛⬛⬛⬛⬜⬛⬜⬛⬛⬛⬛⬛⬜⬛⬛⬛⬛⬛⬜⬛⬛⬛⬜⬛⬛⬛⬜⬛⬜⬛
⬛⬜⬛⬜⬜⬜⬛⬜⬜⬜⬜⬜⬛⬜⬜⬜⬛⬜⬜⬜⬜⬜⬛⬜⬛⬜⬜⬜⬛⬜⬜⬜⬛⬜⬜⬜⬛⬜⬛⬜⬛⬜⬜⬜⬜⬜⬛⬜⬜⬜⬛⬜⬛⬜⬜⬜⬜⬜⬜⬜⬛⬜⬜⬜⬛⬜⬜⬜⬜⬜⬛⬜⬛⬜⬜⬜⬛
⬛⬜⬛⬜⬛⬜⬛⬛⬛⬛⬛⬜⬛⬛⬛⬜⬛⬜⬛⬛⬛⬜⬛⬛⬛⬜⬛⬜⬛⬜⬛⬜⬛⬜⬛⬛⬛⬜⬛⬜⬛⬛⬛⬛⬛⬜⬛⬜⬛⬛⬛⬜⬛⬛⬛⬛⬛⬛⬛⬛⬛⬛⬛⬜⬛⬛⬛⬛⬛⬛⬛⬜⬛⬜⬛⬛⬛
⬛⬜⬛⬜⬛⬜⬛⬜⬜⬜⬛⬜⬜⬜⬛⬜⬛⬜⬛⬜⬜⬜⬜⬜⬜⬜⬛⬜⬛⬜⬛⬜⬛⬜⬛⬜⬜⬜⬛⬜⬜⬜⬛⬜⬜⬜⬛⬜⬜⬜⬛⬜⬜⬜⬛⬜⬜⬜⬜⬜⬜⬜⬜⬜⬜⬜⬜⬜⬛⬜⬜⬜⬜⬜⬛⬜⬛
⬛⬜⬛⬜⬛⬜⬛⬛⬛⬜⬛⬛⬛⬜⬛⬜⬛⬜⬛⬜⬛⬛⬛⬛⬛⬛⬛⬛⬛⬜⬛⬜⬛⬜⬛⬜⬛⬜⬛⬜⬛⬛⬛⬜⬛⬛⬛⬛⬛⬜⬛⬛⬛⬜⬛⬜⬛⬛⬛⬛⬛⬜⬛⬛⬛⬛⬛⬜⬛⬜⬛⬛⬛⬛⬛⬜⬛
⬛⬜⬛⬜⬛⬜⬜⬜⬜⬜⬜⬜⬛⬜⬛⬜⬛⬜⬛⬜⬛⬜⬜⬜⬜⬜⬜⬜⬜⬜⬛⬜⬜⬜⬛⬜⬛⬜⬛⬜⬜⬜⬛⬜⬛⬜⬜⬜⬜⬜⬜⬜⬛⬜⬜⬜⬛⬜⬜⬜⬛⬜⬜⬜⬜⬜⬛⬜⬛⬜⬜⬜⬜⬜⬜⬜⬛
⬛⬜⬛⬜⬛⬛⬛⬛⬛⬛⬛⬛⬛⬜⬛⬜⬛⬜⬛⬛⬛⬜⬛⬛⬛⬛⬛⬛⬛⬛⬛⬛⬛⬛⬛⬜⬛⬛⬛⬛⬛⬜⬛⬜⬛⬜⬛⬛⬛⬛⬛⬜⬛⬛⬛⬛⬛⬛⬛⬜⬛⬛⬛⬛⬛⬜⬛⬛⬛⬛⬛⬛⬛⬛⬛⬜⬛
⬛⬜⬛⬜⬜⬜⬜⬜⬜⬜⬜⬜⬛⬜⬜⬜⬛⬜⬜⬜⬛⬜⬛⬜⬛⬜⬜⬜⬜⬜⬜⬜⬛⬜⬜⬜⬜⬜⬜⬜⬛⬜⬜⬜⬛⬜⬜⬜⬛⬜⬜⬜⬛⬜⬜⬜⬜⬜⬛⬜⬜⬜⬜⬜⬛⬜⬜⬜⬜⬜⬜⬜⬜⬜⬛⬜⬛
⬛⬜⬛⬛⬛⬛⬛⬛⬛⬛⬛⬜⬛⬛⬛⬜⬛⬛⬛⬜⬛⬜⬛⬜⬛⬜⬛⬛⬛⬜⬛⬜⬛⬜⬛⬛⬛⬛⬛⬜⬛⬛⬛⬛⬛⬜⬛⬜⬛⬜⬛⬛⬛⬛⬛⬜⬛⬜⬛⬛⬛⬛⬛⬜⬛⬛⬛⬛⬛⬜⬛⬛⬛⬛⬛⬜⬛
⬛⬜⬜⬜⬜⬜⬜⬜⬛⬜⬛⬜⬜⬜⬜⬜⬜⬜⬛⬜⬛⬜⬛⬜⬜⬜⬛⬜⬜⬜⬛⬜⬛⬜⬜⬜⬜⬜⬛⬜⬜⬜⬛⬜⬛⬜⬛⬜⬛⬜⬜⬜⬜⬜⬜⬜⬛⬜⬛⬜⬜⬜⬜⬜⬜⬜⬜⬜⬛⬜⬜⬜⬛⬜⬜⬜⬛
⬛⬛⬛⬛⬛⬛⬛⬜⬛⬜⬛⬛⬛⬛⬛⬛⬛⬛⬛⬜⬛⬜⬛⬛⬛⬛⬛⬜⬛⬛⬛⬜⬛⬜⬛⬛⬛⬛⬛⬜⬛⬜⬛⬜⬛⬜⬛⬜⬛⬛⬛⬛⬛⬛⬛⬛⬛⬜⬛⬜⬛⬛⬛⬛⬛⬛⬛⬛⬛⬛⬛⬜⬛⬜⬛⬛⬛
⬛⬜⬜⬜⬜⬜⬛⬜⬜⬜⬜⬜⬜⬜⬛⬜⬛⬜⬜⬜⬛⬜⬛⬜⬜⬜⬛⬜⬛⬜⬛⬜⬛⬜⬛⬜⬜⬜⬛⬜⬛⬜⬛⬜⬜⬜⬛⬜⬛⬜⬜⬜⬛⬜⬜⬜⬛⬜⬛⬜⬜⬜⬜⬜⬜⬜⬛⬜⬜⬜⬜⬜⬛⬜⬛⬜⬛
⬛⬛⬛⬜⬛⬜⬛⬛⬛⬛⬛⬛⬛⬜⬛⬜⬛⬜⬛⬜⬛⬜⬛⬜⬛⬜⬛⬜⬛⬜⬛⬜⬛⬜⬛⬜⬛⬜⬛⬜⬛⬜⬛⬜⬛⬛⬛⬜⬛⬜⬛⬜⬛⬜⬛⬜⬛⬜⬛⬜⬛⬛⬛⬛⬛⬜⬛⬜⬛⬛⬛⬛⬛⬜⬛⬜⬛
⬛⬜⬜⬜⬛⬜⬜⬜⬜⬜⬜⬜⬛⬜⬜⬜⬛⬜⬛⬜⬛⬜⬜⬜⬛⬜⬜⬜⬛⬜⬜⬜⬛⬜⬛⬜⬛⬜⬜⬜⬛⬜⬛⬜⬜⬜⬛⬜⬛⬜⬛⬜⬜⬜⬛⬜⬛⬜⬛⬜⬛⬜⬜⬜⬜⬜⬛⬜⬜⬜⬜⬜⬜⬜⬛⬜⬛
⬛⬜⬛⬛⬛⬛⬛⬛⬛⬛⬛⬛⬛⬛⬛⬜⬛⬜⬛⬛⬛⬛⬛⬛⬛⬛⬛⬛⬛⬜⬛⬛⬛⬛⬛⬜⬛⬛⬛⬛⬛⬜⬛⬛⬛⬛⬛⬜⬛⬜⬛⬛⬛⬛⬛⬜⬛⬜⬛⬛⬛⬜⬛⬛⬛⬜⬛⬛⬛⬛⬛⬛⬛⬛⬛⬜⬛
⬛⬜⬜⬜⬜⬜⬜⬜⬜⬜⬜⬜⬜⬜⬜⬜⬛⬜⬜⬜⬜⬜⬜⬜⬜⬜⬜⬜⬜⬜⬜⬜⬜⬜⬜⬜⬛⬜⬜⬜⬜⬜⬜⬜⬜⬜⬜⬜⬛⬜⬜⬜⬜⬜⬛⬜⬜⬜⬜⬜⬜⬜⬛⬜⬜⬜⬜⬜⬜⬜⬜⬜⬜⬜⬜⬜⬛
⬛⬛⬛⬛⬛⬛⬛⬛⬛⬛⬛⬛⬛⬛⬛⬛⬛⬛⬛⬛⬛⬛⬛⬛⬛⬛⬛⬛⬛⬛⬛⬛⬛⬛⬛⬛⬛⬛⬛⬛⬛⬛⬛⬛⬛⬛⬛⬛⬛⬛⬛⬛⬛⬛⬛⬛⬛⬛⬛⬛⬛⬛⬛⬛⬛⬛⬛⬛⬛⬛⬛⬛⬛⬛⬛⬜⬛
