⬛⬜⬛⬛⬛⬛⬛⬛⬛⬛⬛⬛⬛⬛⬛
⬛⬜⬜⬜⬛⬜⬜⬜⬜⬜⬜⬜⬜⬜⬛
⬛⬛⬛⬜⬛⬜⬛⬜⬛⬛⬛⬛⬛⬜⬛
⬛⬜⬜⬜⬛⬜⬛⬜⬛⬜⬜⬜⬜⬜⬛
⬛⬜⬛⬛⬛⬛⬛⬜⬛⬜⬛⬛⬛⬛⬛
⬛⬜⬛⬜⬜⬜⬜⬜⬛⬜⬜⬜⬛⬜⬛
⬛⬜⬛⬜⬛⬛⬛⬛⬛⬛⬛⬜⬛⬜⬛
⬛⬜⬛⬜⬛⬜⬜⬜⬛⬜⬜⬜⬛⬜⬛
⬛⬜⬛⬜⬛⬛⬛⬜⬛⬜⬛⬛⬛⬜⬛
⬛⬜⬛⬜⬜⬜⬛⬜⬛⬜⬜⬜⬛⬜⬛
⬛⬜⬛⬛⬛⬜⬛⬜⬛⬛⬛⬜⬛⬜⬛
⬛⬜⬜⬜⬜⬜⬛⬜⬜⬜⬛⬜⬛⬜⬛
⬛⬛⬛⬛⬛⬛⬛⬜⬛⬜⬛⬜⬛⬜⬛
⬛⬜⬜⬜⬜⬜⬜⬜⬛⬜⬜⬜⬜⬜⬛
⬛⬛⬛⬛⬛⬛⬛⬛⬛⬛⬛⬛⬛⬜⬛
